--------------------------------
--------------------------------
--$**************************$--
--****--**************--******--
--****--**************--******--
--**-------********-------****--
--**-------********-------****--
--****************************--
--***......................***--
--********-----..----*********--
--*-******-...1234..-*******-*--
--*-******-.........-*******-*--
--*--*****-----------******--*--
--*-************************-*--
--*-*......................*-*--
--***...--------------.....***--
--***...--------------.....***--
--***........---...........***--
--***......................***--
--****************************--
--****************************--
--$**************************$--
--------------------------------
--------------------------------