10
10 10 250
0000000000
0000000000
0000000000
0000000000
0000000000
0000000000
0000000000
0000000000
0000000000
0000000000
10 10 300
0011111100
0000000000
0001111000
0000000000
0001001000
0001001000
0000000000
0001111000
0000000000
0111111110
10 10 250
0000000000
1001111001
1000000001
1010110101
1010000101
1010000101
1010110101
1000000001
1000000001
0001111000
20 20 180
00000000000000000000
01111000000011111000
00000000000011111000
00001111000011111000
00000000000000000000
00000001111000000000
00000000000000000000
00000000001111000000
00000000000000000000
00000000000001111000
00000111110000000000
00000111110000001111
00000111110000000000
11110000000000000000
00000000000000000000
00011110000001111100
00000000000001111100
00000011110001111100
00000000000000000000
00000000011110000000
20 20 200
00000000000000000000
00111111111111111100
00000000000000000100
00000000000000000100
00111111111111111100
00100000000000000000
00100000000000000000
00111111111111111100
00000000000000000100
00000000000000000100
00111111111111111100
00100000000000000000
00100000000000000000
00111111111111111100
00000000000000000100
00000000000000000100
00111111111111111100
00100000000000000000
00100000000000000000
00111111111111111000
20 20 250
00000000000000000000
00100100100100100100
00100100100100100100
00100100100100100100
10010010010010010010
10010010010010010010
10010010010010010010
01001001001001001000
01001001001001001000
01001001001001001000
00100100100100100100
00100100100100100100
00100100100100100100
10010010010010010000
10010010010010010000
10010010010010010000
01001001001001001000
01001001001001001000
01001001001001001000
00000000000000000000
15 20 250
00111110000001111100
00000000000000000000
10011100000000111001
10011100111000111001
10000001000100000001
00000010000010000000
00000100000001000000
00000000000000000000
00000100000001000000
00000010000010000000
10000001000100000001
10011100111000111001
10011100000000111001
00000000000000000000
00111110000001111100
15 20 250
00111111111111111100
00000010010010000000
10000010010010000001
10000010010010000001
10011010010010110001
10011010010010110001
00000000000000000000
01111111111111111100
00000000000000000000
10011010010010110001
10011010010010110001
10000010010010000001
10000010010010000001
00000010010010000000
00111111111111111100
20 15 350
001110000011100
000000000000000
101111000111101
101000000000101
101011000110101
001010000010100
000010000010000
100000010000001
101000101000101
101010000010101
101010000010101
101000101000101
100000010000001
000010000010000
001010000010100
101011000110101
101000000000101
101111000111101
000000000000000
001110000011100
20 15 350
001010101010100
000000000000000
101010101010101
100000000000101
101010101010101
101000000010101
101010101010101
101010001010101
101010101010101
101010101010101
101010101010101
101010101010101
101010101010101
101010101010101
101010000010101
101010101010101
101000000000101
101010101010101
000000000000000
001010101010100